MODE 0
SIZE 11/30
LIMIT 0/15
COLOR LIMIT 5
STARS 1500/2800/3900
0 0 0 6 6 6 6 6 6 0 0
0 0 6 6 6 6 6 6 6 0 0
0 0 0 6 6 6 6 6 6 0 0
0 0 0 6 6 6 6 6 0 0 0
0 0 0 6 6 6 6 6 6 0 0
0 0 6 6 6 0 6 6 6 0 0
0 0 0 6 6 6 6 6 6 0 0
0 0 0 6 6 6 6 6 0 0 0
0 0 0 6 6 0 0 6 6 0 0
0 0 0 0 0 0 0 0 0 0 0
0 0 0 0 0 0 0 0 0 0 0
0 0 0 0 0 0 0 0 0 0 0
0 0 0 0 0 0 0 0 0 0 0
0 0 0 0 0 0 0 0 0 0 0
0 0 0 0 0 0 0 0 0 0 0
0 0 0 0 0 0 0 0 0 0 0
0 0 0 0 0 0 0 0 0 0 0
0 0 0 0 0 0 0 0 0 0 0
0 0 0 0 0 0 0 0 0 0 0
0 0 0 0 0 0 0 0 0 0 0
0 0 0 0 0 0 0 0 0 0 0
0 0 0 0 0 0 0 0 0 0 0
0 0 0 0 0 0 0 0 0 0 0
0 0 0 0 0 0 0 0 0 0 0
0 0 0 0 0 0 0 0 0 0 0
0 0 0 0 0 0 0 0 0 0 0
0 0 0 0 0 0 0 0 0 0 0
0 0 0 0 0 0 0 0 0 0 0
0 0 0 0 0 0 0 0 0 0 0
0 0 0 0 0 0 0 0 0 0 0