MODE 0
SIZE 11/30
LIMIT 0/25
COLOR LIMIT 5
STARS 2500/3300/6000
1 1 1 1 1 1 1 1 1 2 2
0 0 0 0 0 0 0 0 2 2 0
0 0 0 0 0 0 0 2 2 0 0
0 0 0 0 0 2 2 0 0 0 0
0 0 0 0 3 3 0 0 0 0 0
0 0 0 0 0 3 3 0 0 0 0
0 0 0 0 0 0 0 3 3 0 0
0 0 0 0 0 0 0 0 3 3 0
4 4 4 4 4 4 4 4 4 4 4
0 0 0 0 0 0 0 0 0 0 0
0 0 0 0 0 0 0 0 0 0 0
0 0 0 0 0 0 0 0 0 0 0
0 0 0 0 0 0 0 0 0 0 0
0 0 0 0 0 0 0 0 0 0 0
0 0 0 0 0 0 0 0 0 0 0
0 0 0 0 0 0 0 0 0 0 0
0 0 0 0 0 0 0 0 0 0 0
0 0 0 0 0 0 0 0 0 0 0
0 0 0 0 0 0 0 0 0 0 0
0 0 0 0 0 0 0 0 0 0 0
0 0 0 0 0 0 0 0 0 0 0
0 0 0 0 0 0 0 0 0 0 0
0 0 0 0 0 0 0 0 0 0 0
0 0 0 0 0 0 0 0 0 0 0
0 0 0 0 0 0 0 0 0 0 0
0 0 0 0 0 0 0 0 0 0 0
0 0 0 0 0 0 0 0 0 0 0
0 0 0 0 0 0 0 0 0 0 0
0 0 0 0 0 0 0 0 0 0 0
0 0 0 0 0 0 0 0 0 0 0