MODE 0
SIZE 11/30
LIMIT 0/15
COLOR LIMIT 4
STARS 1000/2500/3800
0 0 0 5 3 3 3 3 1 0 0
0 0 0 5 3 3 3 1 0 0 0
0 0 0 0 6 3 3 6 0 0 0
0 0 0 6 6 6 6 6 0 0 0
0 0 0 6 0 6 6 0 6 0 0
0 0 0 6 6 0 6 6 0 0 0
0 0 0 6 0 6 6 0 6 0 0
0 0 0 6 6 6 6 6 0 0 0
0 0 0 0 6 0 0 6 0 0 0
0 0 0 0 0 0 0 0 0 0 0
0 0 0 0 0 0 0 0 0 0 0
0 0 0 0 0 0 0 0 0 0 0
0 0 0 0 0 0 0 0 0 0 0
0 0 0 0 0 0 0 0 0 0 0
0 0 0 0 0 0 0 0 0 0 0
0 0 0 0 0 0 0 0 0 0 0
0 0 0 0 0 0 0 0 0 0 0
0 0 0 0 0 0 0 0 0 0 0
0 0 0 0 0 0 0 0 0 0 0
0 0 0 0 0 0 0 0 0 0 0
0 0 0 0 0 0 0 0 0 0 0
0 0 0 0 0 0 0 0 0 0 0
0 0 0 0 0 0 0 0 0 0 0
0 0 0 0 0 0 0 0 0 0 0
0 0 0 0 0 0 0 0 0 0 0
0 0 0 0 0 0 0 0 0 0 0
0 0 0 0 0 0 0 0 0 0 0
0 0 0 0 0 0 0 0 0 0 0
0 0 0 0 0 0 0 0 0 0 0
0 0 0 0 0 0 0 0 0 0 0